#####################
#e# #         #     #
#d# # # ##### # # ###
#c#   # #     # #   #
#*##### # ##### ### #
#?#     #   #   # # #
#&# #######&# ### # #
# #   #   # # #   # #
# ### # # # # ### # #
#^    # # # #     # #
####### ### ####### #
# #       # #     # #
# # ##### # # ### # #
#   #     # #   #c ?#
# ### ##### ### ### #
#   #           #   =
#####################